SO /Users/gromero-/cursus/cub3d/textures/s.png
NO            				/Users/gromero-/cursus/cub3d/textures/n.png
  F 		164   ,   169,    20
WE /Users/gromero-/cursus/cub3d/textures/w.png
EA /Users/gromero-/cursus/cub3d/textures/e.png

	
C 153,204,255


111111111 1111111111111
101000001 1000000000001
111111111 1011111110001
          100000100011
111111111111101011101
100000101000101000001
101111101011101111111
101000001010100000101
101011111010111110101
101010001010100010101
101110101010101010101
100000101010001010001
111111101011111011101
100000101000100010001
101110101110101110111
101000100000100010101
101011111111111010101
100010000000000010001
101010111011111111101
1N1000001000000000001
111111111111111111111







