NO            				textures/1.png
SO ./textures/2.png
WE ./textures/3.png
EA ./textures/4.png
  F 164,169,20
C 153,204,255
1111111111
1000010001
1000100001
1001000001
1010000001
1000000001
1000N00001
1111111111
